DATA "A:\LEVELS\10.LVL"
DATA "0000000000000000"
DATA "0000000000000000"
DATA "0000000000000000"
DATA "0000000000000000"
DATA "0000000000000000"
DATA "0000000000000000"
DATA "0000000000000000"
DATA "0000000000000000"
DATA "0000000000000000"
DATA "0000000000000000"
DATA "0000000000000000"
DATA "0000000000000000"
DATA "2010201020102000"
DATA "0000000000000000"
DATA "0101010101010100"
DATA "0000000000000000"
DATA "1020102010201000"
DATA "0000000000000000"
DATA "0101010101010100"
DATA "0000000000000000"
DATA "2010201020102000"
DATA "0000000000000000"
DATA "0101010101010100"
DATA "0000000000000000"
