DATA "A:\LEVELS\9.LVL"
DATA "0000000000000000"
DATA "0000000000000000"
DATA "0000000000000000"
DATA "0000000000000000"
DATA "0000000000000000"
DATA "0000000000000000"
DATA "0000000000000000"
DATA "0000000000000000"
DATA "0000000000000000"
DATA "0000000000000000"
DATA "0000000000000000"
DATA "0000000000000000"
DATA "0000000000000000"
DATA "0000000000000000"
DATA "0002000000200000"
DATA "0002000000200000"
DATA "0001000000100000"
DATA "0001000000100000"
DATA "0021200002120000"
DATA "0021200002120000"
DATA "0011100001110000"
DATA "0011100001110000"
DATA "0212120021212000"
DATA "0212120021212000"
