 1, 1, 1, 1, 1, 1, 1, 1, 1, 6, 6, 1, 1, 1, 1, 1, 1, 1, 1, 1, 
 1, 1, 1, 1, 1, 1, 1, 1, 1, 6, 6, 1, 1, 1, 1, 1, 1, 1, 1, 1, 
 1, 1, 1, 1, 1, 1, 1, 1, 1, 6, 6, 1, 1, 1, 1, 1, 1, 1, 1, 1, 
 1, 1, 1, 1, 1, 1, 1, 1, 1, 6, 6, 1, 1, 1, 1, 1, 1, 1, 1, 1, 
 1, 1, 1, 1, 1, 1, 1, 1, 1, 6, 6, 1, 1, 1, 1, 1, 1, 1, 1, 1, 
 1, 1, 1, 1, 1, 1, 1, 1, 1, 6, 6, 1, 1, 1, 1, 1, 1, 1, 1, 1, 
 1, 1, 1, 1, 1, 1, 1, 1, 1, 6, 6, 1, 1, 1, 1, 1, 1, 1, 1, 1, 
 1, 1, 1, 1, 1, 1, 1, 1, 1, 6, 6, 1, 1, 1, 1, 1, 1, 1, 1, 1, 
 1, 1, 1, 1, 1, 1, 1, 1, 1, 6, 6, 1, 1, 1, 1, 1, 1, 1, 1, 1, 
 1, 1, 1, 1, 1, 1, 1, 1, 1, 6, 6, 1, 1, 1, 1, 1, 1, 1, 1, 1, 
 1, 1, 1, 1, 1, 1, 1, 1, 1, 6, 6, 1, 1, 1, 1, 1, 1, 1, 1, 1, 
 1, 1, 1, 1, 1, 1, 1, 1, 1, 6, 6, 1, 1, 1, 1, 1, 1, 1, 1, 1, 
 1, 1, 1, 1, 1, 1, 1, 1, 1, 6, 6, 1, 1, 1, 1, 1, 1, 1, 1, 1, 
 1, 1, 1, 1, 1, 1, 1, 1, 1, 6, 6, 1, 1, 1, 1, 1, 1, 1, 1, 1, 
 1, 1, 1, 1, 1, 1, 1, 1, 1, 6, 6, 1, 1, 1, 1, 1, 1, 1, 1, 1, 
 11, 11, 11, 11, 11, 11, 11, 11, 11, 6, 6, 11, 11, 11, 11, 11, 11, 11, 11, 11, 
 1, 2, 16, 16, 16, 16, 3, 1, 1, 6, 6, 1, 2, 16, 17, 16, 16, 3, 1, 11, 
 1, 1, 1, 1, 1, 1, 1, 1, 1, 6, 6, 1, 1, 1, 1, 1, 1, 1, 1, 1, 
 4, 1, 1, 1, 7, 1, 7, 1, 7, 1, 7, 1, 7, 1, 7, 1, 7, 1, 7, 1, 
 3, 1, 1, 1, 1, 1, 1, 1, 1, 1, 1, 1, 1, 1, 1, 1, 1, 1, 1, 1, 
 1, 1, 1, 7, 1, 7, 1, 7, 1, 7, 1, 7, 1, 7, 1, 7, 1, 7, 1, 1, 
 1, 1, 1, 1, 1, 1, 1, 1, 1, 1, 1, 1, 1, 1, 1, 1, 1, 1, 1, 1, 
 1, 1, 1, 1, 7, 1, 7, 1, 7, 1, 7, 1, 7, 1, 7, 1, 7, 1, 7, 1, 
 5, 6, 6, 16, 6, 16, 6, 8, 6, 16, 6, 16, 6, 6, 8, 4, 1, 1, 1, 1, 
 6, 3, 1, 1, 1, 1, 1, 1, 1, 1, 1, 1, 2, 6, 6, 6, 4, 1, 1, 1, 
 8, 1, 1, 1, 1, 1, 1, 1, 1, 1, 1, 1, 1, 2, 6, 8, 6, 4, 1, 1, 
 6, 4, 1, 1, 1, 1, 1, 1, 1, 1, 1, 1, 1, 1, 2, 6, 6, 6, 4, 1, 
 6, 6, 6, 4, 1, 1, 1, 1, 1, 1, 1, 1, 1, 1, 1, 2, 6, 6, 6, 4, 
 3, 2, 6, 8, 4, 1, 1, 1, 1, 1, 1, 1, 1, 1, 1, 1, 2, 6, 6, 8, 
 1, 1, 2, 6, 6, 6, 4, 1, 1, 1, 1, 1, 1, 1, 1, 1, 1, 2, 6, 6, 
 1, 1, 1, 1, 2, 6, 6, 6, 4, 1, 1, 1, 1, 1, 1, 1, 1, 1, 2, 6, 
 1, 1, 1, 1, 1, 1, 2, 6, 8, 6, 4, 1, 1, 1, 1, 1, 1, 1, 1, 1, 
 1, 1, 1, 1, 1, 1, 1, 1, 2, 6, 6, 6, 4, 1, 1, 1, 1, 1, 1, 1, 
 4, 1, 1, 1, 1, 1, 1, 1, 1, 1, 2, 6, 6, 6, 4, 1, 1, 1, 1, 1, 
 6, 1, 1, 1, 1, 1, 1, 1, 1, 1, 1, 1, 2, 6, 6, 6, 6, 6, 8, 6, 
 6, 4, 1, 1, 1, 1, 1, 1, 1, 1, 1, 1, 1, 1, 1, 1, 1, 1, 1, 1, 
 6, 6, 6, 6, 6, 6, 6, 6, 4, 1, 1, 1, 7, 1, 1, 1, 1, 1, 7, 1, 
 6, 8, 8, 8, 8, 8, 8, 8, 6, 4, 1, 1, 1, 7, 1, 1, 1, 7, 1, 1, 
 8, 16, 16, 8, 6, 8, 16, 16, 8, 6, 1, 1, 1, 1, 7, 7, 7, 1, 1, 1, 
 8, 6, 16, 6, 8, 6, 16, 6, 8, 6, 1, 1, 1, 1, 7, 7, 7, 1, 1, 1, 
 6, 8, 8, 8, 8, 8, 8, 8, 6, 3, 1, 1, 1, 1, 7, 7, 7, 1, 1, 1, 
 6, 6, 6, 6, 6, 6, 6, 6, 3, 1, 1, 1, 1, 7, 1, 1, 1, 7, 1, 1, 
 6, 3, 1, 1, 1, 1, 1, 1, 1, 1, 1, 1, 7, 1, 1, 1, 1, 1, 7, 1, 
 6, 1, 1, 1, 1, 1, 1, 7, 1, 1, 1, 1, 1, 1, 1, 1, 1, 1, 1, 1, 
 3, 1, 1, 1, 1, 1, 7, 7, 7, 1, 1, 1, 1, 1, 1, 1, 1, 1, 1, 1, 
 1, 1, 1, 1, 1, 7, 7, 7, 7, 7, 1, 1, 1, 1, 11, 11, 11, 11, 1, 1, 
 1, 1, 1, 1, 1, 1, 1, 1, 1, 1, 1, 1, 1, 1, 11, 6, 8, 11, 1, 1, 
 1, 1, 1, 1, 1, 1, 1, 1, 1, 1, 1, 1, 1, 1, 11, 8, 6, 11, 1, 1, 
 7, 1, 1, 1, 1, 1, 1, 1, 11, 11, 11, 11, 11, 11, 5, 6, 6, 4, 11, 11, 
 7, 7, 1, 1, 1, 1, 1, 1, 6, 6, 16, 6, 16, 8, 16, 6, 16, 6, 16, 8, 
 7, 7, 7, 1, 1, 1, 1, 1, 6, 8, 6, 6, 8, 6, 6, 8, 6, 6, 8, 6, 
 7, 7, 7, 7, 1, 1, 1, 1, 1, 1, 1, 1, 1, 1, 2, 6, 6, 8, 6, 6, 
 1, 1, 1, 1, 1, 1, 1, 1, 1, 1, 1, 1, 1, 1, 1, 6, 8, 3, 1, 1, 
 1, 1, 1, 1, 1, 1, 1, 1, 1, 1, 1, 1, 1, 1, 1, 8, 6, 1, 1, 1, 
 6, 6, 8, 6, 6, 6, 6, 8, 6, 6, 4, 1, 1, 1, 1, 1, 1, 1, 1, 1, 
 1, 1, 1, 1, 1, 1, 1, 1, 1, 2, 6, 1, 1, 1, 1, 1, 1, 1, 1, 1, 
 11, 11, 11, 11, 11, 11, 11, 11, 1, 1, 6, 1, 1, 1, 1, 1, 1, 1, 1, 7, 
 11, 11, 11, 11, 11, 11, 11, 11, 11, 1, 8, 1, 1, 1, 1, 1, 1, 1, 7, 7, 
 11, 11, 11, 11, 11, 11, 11, 11, 1, 1, 6, 1, 1, 1, 1, 1, 1, 7, 7, 7, 
 1, 1, 1, 1, 1, 1, 1, 1, 1, 5, 3, 1, 1, 1, 1, 1, 7, 7, 7, 7, 
 6, 6, 8, 6, 6, 6, 8, 6, 6, 3, 11, 11, 11, 11, 11, 7, 7, 7, 7, 7, 
 1, 1, 1, 1, 1, 1, 1, 1, 1, 1, 1, 1, 1, 1, 7, 7, 7, 7, 7, 7, 
 1, 1, 1, 1, 1, 1, 1, 1, 1, 1, 1, 1, 1, 7, 7, 7, 7, 7, 7, 7, 
 11, 11, 11, 11, 11, 11, 11, 11, 11, 11, 11, 1, 1, 11, 11, 11, 11, 11, 11, 11, 
 1, 1, 1, 1, 1, 1, 1, 1, 1, 1, 11, 1, 1, 11, 1, 1, 1, 1, 1, 1, 
 1, 1, 1, 1, 1, 1, 1, 1, 1, 1, 1, 1, 5, 4, 1, 1, 1, 1, 1, 1, 
 1, 1, 1, 7, 7, 7, 1, 1, 1, 5, 4, 1, 8, 8, 1, 5, 4, 1, 1, 1, 
 1, 1, 1, 7, 7, 7, 1, 1, 1, 8, 8, 6, 8, 8, 6, 8, 8, 1, 1, 1, 
 1, 1, 1, 7, 7, 7, 1, 1, 1, 8, 8, 8, 8, 8, 8, 8, 8, 1, 1, 1, 
 1, 1, 1, 1, 1, 1, 1, 1, 1, 8, 8, 6, 8, 8, 6, 8, 8, 1, 1, 1, 
 1, 1, 1, 1, 1, 1, 1, 1, 1, 8, 8, 3, 1, 1, 2, 8, 8, 1, 1, 1, 
 1, 1, 1, 1, 1, 1, 1, 1, 1, 2, 3, 1, 1, 1, 1, 2, 3, 1, 1, 1, 
 1, 1, 1, 1, 1, 1, 1, 1, 1, 1, 1, 7, 1, 1, 7, 1, 1, 1, 1, 1, 
 4, 11, 11, 1, 11, 11, 1, 1, 11, 11, 7, 1, 7, 7, 1, 7, 11, 11, 1, 1, 
 6, 4, 11, 1, 11, 11, 1, 1, 11, 7, 1, 1, 1, 1, 1, 1, 7, 11, 1, 11, 
 2, 6, 4, 1, 1, 1, 1, 1, 7, 7, 7, 7, 7, 7, 7, 7, 7, 7, 11, 1, 
 1, 2, 6, 4, 1, 1, 1, 1, 1, 7, 7, 7, 7, 7, 7, 7, 7, 11, 1, 1, 
 1, 1, 2, 6, 4, 1, 11, 1, 1, 1, 7, 7, 7, 7, 7, 7, 11, 1, 1, 1, 
 1, 1, 1, 2, 6, 4, 1, 11, 1, 1, 1, 7, 7, 7, 7, 1, 11, 1, 1, 1, 
 1, 1, 1, 1, 2, 6, 4, 1, 11, 1, 1, 1, 7, 7, 1, 1, 11, 1, 1, 1, 
 1, 1, 1, 1, 1, 2, 6, 4, 1, 11, 1, 1, 1, 1, 1, 1, 11, 1, 1, 1, 
 1, 1, 1, 1, 1, 1, 2, 6, 4, 1, 11, 1, 1, 1, 1, 1, 11, 1, 1, 1, 
 1, 1, 1, 1, 1, 1, 1, 2, 6, 4, 1, 11, 1, 1, 1, 1, 11, 1, 1, 1, 
 11, 11, 11, 11, 11, 1, 1, 1, 2, 6, 4, 1, 11, 1, 1, 1, 11, 1, 1, 1, 
 1, 1, 1, 1, 1, 11, 1, 1, 1, 2, 8, 4, 1, 11, 1, 1, 11, 1, 1, 1, 
 1, 1, 1, 1, 7, 1, 11, 1, 1, 1, 2, 6, 4, 1, 11, 11, 11, 1, 1, 1, 
 1, 1, 1, 7, 7, 7, 11, 1, 1, 1, 1, 2, 6, 4, 1, 1, 1, 1, 1, 1, 
 1, 1, 1, 1, 7, 1, 11, 1, 1, 1, 1, 1, 2, 6, 4, 1, 1, 1, 1, 1, 
 1, 1, 1, 1, 7, 1, 11, 1, 1, 1, 1, 1, 1, 2, 8, 4, 1, 1, 1, 1, 
 1, 1, 1, 1, 7, 1, 1, 11, 11, 11, 1, 1, 1, 1, 2, 6, 4, 1, 1, 1, 
 1, 1, 1, 7, 7, 7, 1, 1, 1, 1, 11, 1, 1, 1, 1, 2, 6, 4, 1, 1, 
 1, 1, 7, 7, 7, 7, 7, 1, 1, 1, 11, 1, 1, 1, 1, 1, 2, 8, 4, 1, 
 1, 1, 7, 7, 7, 7, 7, 1, 1, 1, 11, 1, 1, 1, 1, 1, 1, 2, 6, 1, 
 1, 1, 7, 7, 7, 7, 7, 1, 1, 1, 11, 1, 1, 1, 1, 1, 1, 1, 6, 1, 
 1, 1, 1, 7, 7, 7, 1, 1, 1, 1, 11, 11, 11, 11, 11, 11, 11, 11, 8, 1, 
 1, 1, 1, 1, 1, 1, 1, 1, 1, 1, 1, 1, 1, 1, 1, 1, 1, 1, 6, 1, 
 1, 1, 1, 1, 1, 1, 5, 6, 6, 6, 6, 6, 6, 6, 8, 6, 6, 6, 6, 1, 
 6, 6, 8, 6, 6, 6, 6, 3, 1, 6, 6, 1, 1, 1, 1, 1, 1, 1, 1, 1, 
 1, 1, 1, 1, 1, 1, 1, 1, 1, 6, 6, 1, 1, 1, 1, 1, 1, 1, 1, 1, 
 1, 1, 1, 1, 1, 1, 1, 1, 1, 6, 6, 1, 1, 1, 1, 1, 1, 1, 1, 1, 
 1, 1, 1, 1, 1, 1, 1, 1, 1, 6, 6, 1, 1, 1, 1, 1, 1, 1, 1, 1, 
 1, 1, 1, 1, 1, 1, 1, 1, 1, 6, 6, 1, 1, 1, 1, 1, 1, 1, 1, 1, 
 1, 1, 1, 1, 1, 1, 1, 1, 1, 6, 6, 1, 1, 1, 1, 1, 1, 1, 1, 1, 
 1, 1, 1, 1, 1, 1, 1, 1, 1, 6, 6, 1, 1, 1, 1, 1, 1, 1, 1, 1, 
 1, 1, 1, 1, 1, 1, 1, 1, 1, 6, 6, 1, 1, 1, 1, 1, 1, 1, 1, 1, 
 1, 1, 1, 1, 1, 1, 1, 1, 1, 6, 6, 1, 1, 1, 1, 1, 1, 1, 1, 1, 
 1, 1, 1, 1, 1, 1, 1, 1, 1, 6, 6, 1, 1, 1, 1, 1, 1, 1, 1, 1, 
 1, 1, 1, 1, 1, 1, 1, 1, 1, 6, 6, 1, 1, 1, 1, 1, 1, 1, 1, 1, 
 1, 1, 1, 1, 1, 1, 1, 1, 1, 6, 6, 1, 1, 1, 1, 1, 1, 1, 1, 1, 
 1, 1, 1, 1, 1, 1, 1, 1, 1, 6, 6, 1, 1, 1, 1, 1, 1, 1, 1, 1, 
 1, 1, 1, 1, 1, 1, 1, 1, 1, 6, 6, 1, 1, 1, 1, 1, 1, 1, 1, 1, 
 1, 1, 1, 1, 1, 1, 1, 1, 1, 6, 6, 1, 1, 1, 1, 1, 1, 1, 1, 1, 
