 +-----------+-----+-+-------+-----+-----+
 |           |     = |       |     |     |
 | . . . . . +-- --- | . . . | . . | . . |
 |           |     | |                   |
 +---------+#+ . . | | . . . | . . | . . |
 |         |       | |       |     |     |
 | . . . . +#+ . . | | . . . | . . | . . |
 |           |     | |       |     |     |
 +-----------+-----+ +-------+ . . +-----+
 |                                       |
 +-------+-------+-+ +-------+---+ +---+-+
 |       s       = = =       |   | |   | |
 +~------+-------+-+ +---+ . | --+ +-- +#+
 |       =         | |   =   |   = =     |
 +~+ . . | . . . . | +---+---+-+-+#+-+-+-+
 | |     |         | |   =   | =     | s |
 | +-+---+ . . . . | +---+ . | +-----+ + |
 |   |   =         | =       |     =   | |
 | . +#+-----------+#+-------+---------+#+
 |   | =           = |       =         = |
 +---+-+-----------+-+-------+---------+-+
                                          
