 8, 9, 8, 9, 8, 9, 8, 9, 8, 9, 8, 9, 8, 9, 8, 9, 8, 9, 8, 9, 8, 9, 8, 9, 8, 9, 8, 9, 8, 9, 8, 9, 8, 9, 8, 9, 8, 9, 8, 9, 8, 9, 8, 9, 8, 9, 8, 9, 8, 9, 8, 9, 8, 9, 8, 9, 8, 9, 8, 9, 8, 9, 8, 9, 8, 9, 8, 9, 8, 9, 8, 9, 8, 9, 8, 9, 8, 9, 8, 9, 
 9, 8, 9, 8, 9, 8, 9, 8, 9, 8, 9, 8, 9, 8, 9, 8, 9, 8, 9, 8, 9, 8, 9, 8, 9, 8, 9, 8, 9, 8, 9, 8, 9, 8, 9, 8, 9, 8, 9, 8, 9, 8, 9, 8, 9, 8, 9, 8, 9, 8, 9, 8, 9, 8, 9, 8, 9, 8, 9, 8, 9, 8, 9, 8, 9, 8, 9, 8, 9, 8, 9, 8, 9, 8, 9, 8, 9, 8, 9, 8, 
 8, 9, 8, 9, 8, 9, 8, 9, 8, 9, 8, 9, 8, 9, 8, 9, 8, 9, 8, 9, 8, 9, 8, 9, 8, 9, 8, 9, 8, 9, 8, 9, 8, 9, 8, 9, 8, 9, 8, 9, 8, 9, 8, 9, 8, 9, 8, 9, 8, 9, 8, 9, 8, 9, 8, 9, 8, 9, 8, 9, 8, 9, 8, 9, 8, 9, 8, 9, 8, 9, 8, 9, 8, 9, 8, 9, 8, 9, 8, 9, 
 9, 8, 9, 8, 9, 8, 9, 8, 9, 8, 9, 8, 9, 8, 9, 8, 9, 8, 9, 8, 9, 8, 9, 8, 9, 8, 9, 8, 9, 8, 9, 8, 9, 8, 9, 8, 9, 8, 9, 8, 9, 8, 9, 8, 9, 8, 9, 8, 9, 8, 9, 8, 9, 8, 9, 8, 9, 8, 9, 8, 9, 8, 9, 8, 9, 8, 9, 8, 9, 8, 9, 8, 9, 8, 9, 8, 9, 8, 9, 8, 
 8, 9, 8, 9, 8, 9, 8, 9, 8, 9, 8, 9, 8, 9, 8, 9, 8, 9, 8, 9, 8, 9, 8, 9, 8, 9, 8, 9, 8, 9, 8, 9, 8, 9, 8, 9, 8, 9, 8, 9, 8, 9, 8, 9, 8, 9, 8, 9, 8, 9, 8, 9, 8, 9, 8, 9, 8, 9, 8, 9, 8, 9, 8, 9, 8, 9, 8, 9, 8, 9, 8, 9, 8, 9, 8, 9, 8, 9, 8, 9, 
 9, 8, 9, 8, 9, 8, 9, 8, 9, 8, 9, 8, 9, 8, 9, 8, 9, 8, 9, 8, 9, 8, 9, 8, 9, 8, 9, 8, 9, 8, 9, 8, 9, 8, 9, 8, 9, 8, 9, 8, 9, 8, 9, 8, 9, 8, 9, 8, 9, 8, 9, 8, 9, 8, 9, 8, 9, 8, 9, 8, 9, 8, 9, 8, 9, 8, 9, 8, 9, 8, 9, 8, 9, 8, 9, 8, 9, 8, 9, 8, 
 8, 9, 8, 9, 8, 9, 8, 9, 8, 9, 1, 1, 1, 1, 1, 1, 1, 1, 1, 1, 1, 1, 1, 1, 1, 1, 1, 1, 1, 1, 1, 1, 1, 1, 1, 1, 1, 1, 1, 1, 1, 1, 1, 1, 1, 1, 1, 1, 1, 1, 1, 1, 1, 1, 1, 1, 1, 1, 1, 1, 1, 1, 1, 1, 1, 1, 1, 1, 1, 1, 8, 9, 8, 9, 8, 9, 8, 9, 8, 9, 
 9, 8, 9, 8, 9, 8, 9, 8, 9, 8, 1, 1, 1, 1, 1, 1, 1, 1, 1, 1, 1, 1, 1, 1, 1, 1, 1, 1, 1, 1, 1, 1, 1, 1, 1, 1, 1, 1, 1, 1, 1, 1, 1, 1, 1, 1, 1, 1, 1, 1, 1, 1, 1, 1, 1, 1, 1, 1, 1, 1, 1, 1, 1, 1, 1, 1, 1, 1, 1, 1, 9, 8, 9, 8, 9, 8, 9, 8, 9, 8, 
 8, 9, 8, 9, 8, 9, 8, 9, 8, 9, 1, 1, 1, 1, 1, 1, 1, 1, 1, 1, 1, 1, 1, 1, 1, 1, 1, 1, 1, 1, 1, 1, 1, 1, 1, 1, 1, 1, 1, 1, 1, 1, 1, 1, 1, 1, 1, 1, 1, 1, 1, 1, 1, 1, 1, 1, 1, 1, 1, 1, 1, 1, 1, 1, 1, 1, 1, 1, 1, 1, 8, 9, 8, 9, 8, 9, 8, 9, 8, 9, 
 9, 8, 9, 8, 9, 8, 9, 8, 9, 8, 1, 1, 1, 1, 1, 1, 1, 1, 1, 1, 1, 1, 1, 1, 1, 1, 1, 1, 1, 1, 1, 1, 1, 1, 1, 1, 1, 1, 1, 1, 1, 1, 1, 1, 1, 1, 1, 1, 1, 1, 1, 1, 1, 1, 1, 1, 1, 1, 1, 1, 1, 1, 1, 1, 1, 1, 1, 1, 1, 1, 9, 8, 9, 8, 9, 8, 9, 8, 9, 8, 
 8, 9, 8, 9, 8, 9, 8, 9, 8, 9, 1, 1, 1, 1, 1, 1, 1, 1, 1, 1, 1, 1, 1, 1, 1, 1, 1, 1, 1, 1, 1, 1, 1, 1, 2, 3, 4, 5, 6, 7, 2, 3, 7, 1, 1, 1, 1, 1, 1, 1, 1, 1, 1, 1, 1, 1, 1, 1, 1, 1, 1, 1, 1, 1, 1, 1, 1, 1, 1, 1, 8, 9, 8, 9, 8, 9, 8, 9, 8, 9, 
 9, 8, 9, 8, 9, 8, 9, 8, 9, 8, 2, 3, 4, 5, 6, 7, 2, 3, 4, 5, 6, 7, 1, 1, 1, 2, 3, 4, 5, 6, 7, 2, 3, 7, 9, 8, 9, 9, 8, 9, 9, 8, 9, 2, 3, 4, 5, 6, 7, 2, 3, 7, 1, 1, 1, 1, 1, 1, 1, 1, 1, 1, 1, 1, 1, 1, 1, 1, 1, 1, 9, 8, 9, 8, 9, 8, 9, 8, 9, 8, 
 8, 9, 8, 9, 8, 9, 8, 9, 8, 9, 9, 8, 9, 9, 8, 9, 9, 8, 9, 9, 8, 9, 1, 1, 1, 9, 8, 9, 9, 8, 9, 9, 8, 9, 8, 9, 8, 11, 10, 11, 10, 9, 8, 9, 8, 9, 9, 8, 9, 8, 9, 8, 2, 3, 7, 1, 1, 1, 1, 1, 1, 1, 1, 1, 1, 1, 1, 1, 1, 1, 8, 9, 8, 9, 8, 9, 8, 9, 8, 9, 
 9, 8, 9, 8, 9, 8, 9, 8, 9, 8, 8, 9, 8, 8, 9, 8, 8, 9, 8, 8, 9, 8, 1, 1, 1, 8, 9, 8, 8, 9, 8, 8, 9, 8, 8, 9, 8, 10, 12, 13, 11, 1, 1, 8, 9, 8, 8, 9, 8, 9, 8, 9, 8, 9, 8, 2, 3, 7, 1, 1, 1, 1, 1, 1, 1, 1, 1, 1, 1, 1, 9, 8, 9, 8, 9, 8, 9, 8, 9, 8, 
 8, 9, 8, 9, 8, 9, 8, 9, 8, 9, 1, 1, 1, 1, 1, 1, 1, 1, 1, 1, 1, 1, 1, 1, 1, 1, 1, 1, 1, 1, 1, 8, 9, 8, 9, 8, 9, 11, 14, 15, 10, 1, 1, 1, 1, 1, 1, 1, 1, 8, 9, 8, 9, 8, 9, 8, 9, 8, 1, 1, 1, 1, 1, 1, 1, 1, 1, 1, 1, 1, 8, 9, 8, 9, 8, 9, 8, 9, 8, 9, 
 9, 8, 9, 8, 9, 8, 9, 8, 9, 8, 1, 1, 1, 1, 1, 1, 1, 1, 1, 1, 1, 1, 1, 1, 1, 1, 1, 1, 1, 1, 1, 9, 8, 9, 8, 9, 8, 10, 11, 10, 11, 1, 1, 1, 1, 1, 1, 1, 1, 1, 1, 1, 8, 9, 8, 9, 8, 9, 2, 3, 7, 1, 1, 1, 1, 1, 1, 1, 1, 1, 9, 8, 9, 8, 9, 8, 9, 8, 9, 8, 
 8, 9, 8, 9, 8, 9, 8, 9, 8, 9, 1, 1, 1, 1, 1, 1, 1, 1, 1, 1, 1, 1, 1, 1, 1, 1, 1, 1, 1, 1, 1, 8, 9, 8, 1, 1, 1, 1, 1, 1, 1, 1, 1, 1, 1, 1, 1, 1, 1, 1, 1, 1, 1, 1, 1, 8, 9, 8, 9, 8, 9, 2, 3, 7, 1, 1, 1, 1, 1, 1, 8, 9, 8, 9, 8, 9, 8, 9, 8, 9, 
 9, 8, 9, 8, 9, 8, 9, 8, 9, 8, 1, 1, 1, 2, 3, 4, 5, 6, 7, 2, 3, 4, 5, 6, 7, 2, 3, 7, 1, 1, 1, 1, 1, 1, 1, 1, 1, 1, 1, 1, 1, 1, 1, 1, 1, 1, 1, 1, 1, 1, 1, 1, 1, 1, 1, 1, 1, 1, 8, 9, 8, 9, 8, 9, 2, 3, 7, 1, 1, 1, 9, 8, 9, 8, 9, 8, 9, 8, 9, 8, 
 8, 9, 8, 9, 8, 9, 8, 9, 8, 9, 1, 1, 1, 9, 8, 9, 9, 8, 8, 9, 8, 9, 9, 8, 9, 9, 8, 9, 2, 1, 1, 1, 1, 1, 1, 1, 1, 1, 1, 1, 1, 1, 1, 1, 1, 1, 1, 1, 1, 1, 1, 1, 1, 1, 1, 1, 1, 1, 1, 1, 1, 8, 9, 8, 9, 8, 9, 2, 3, 4, 8, 9, 8, 9, 8, 9, 8, 9, 8, 9, 
 9, 8, 9, 8, 9, 8, 9, 8, 9, 8, 1, 1, 1, 8, 9, 8, 8, 9, 9, 8, 9, 8, 9, 12, 13, 8, 9, 8, 9, 2, 1, 1, 1, 1, 2, 3, 4, 5, 6, 7, 2, 3, 7, 1, 1, 1, 2, 3, 4, 5, 6, 7, 1, 1, 1, 1, 1, 1, 1, 1, 1, 1, 1, 1, 8, 9, 8, 9, 8, 9, 9, 8, 9, 8, 9, 8, 9, 8, 9, 8, 
 8, 9, 8, 9, 8, 9, 8, 9, 8, 9, 1, 1, 1, 1, 1, 1, 1, 1, 8, 9, 8, 9, 8, 14, 15, 9, 8, 9, 8, 9, 2, 3, 4, 7, 9, 8, 9, 9, 8, 9, 9, 8, 9, 1, 1, 1, 9, 8, 9, 9, 8, 9, 2, 3, 7, 1, 1, 1, 1, 1, 1, 1, 1, 1, 1, 1, 1, 8, 9, 8, 8, 9, 8, 9, 8, 9, 8, 9, 8, 9, 
 9, 8, 9, 8, 9, 8, 9, 8, 9, 8, 1, 1, 1, 1, 1, 1, 1, 1, 1, 1, 1, 8, 9, 8, 9, 8, 9, 8, 9, 8, 9, 9, 8, 9, 8, 9, 8, 8, 9, 8, 8, 9, 8, 1, 1, 1, 8, 9, 8, 8, 9, 8, 9, 8, 9, 1, 1, 1, 1, 1, 1, 1, 1, 1, 1, 1, 1, 1, 1, 1, 9, 8, 9, 8, 9, 8, 9, 8, 9, 8, 
 8, 9, 8, 9, 8, 9, 8, 9, 8, 9, 1, 1, 1, 1, 1, 1, 1, 1, 1, 1, 1, 1, 1, 1, 1, 1, 1, 1, 8, 9, 8, 8, 9, 8, 1, 1, 1, 1, 1, 1, 8, 9, 8, 1, 1, 1, 8, 9, 12, 13, 9, 8, 9, 8, 8, 2, 3, 4, 5, 6, 7, 1, 1, 1, 1, 1, 1, 1, 1, 1, 8, 9, 8, 9, 8, 9, 8, 9, 8, 9, 
 9, 8, 9, 8, 9, 8, 9, 8, 9, 8, 1, 1, 1, 1, 1, 1, 1, 1, 1, 1, 1, 1, 1, 1, 1, 1, 1, 1, 1, 1, 1, 1, 1, 1, 1, 1, 1, 1, 1, 1, 9, 8, 9, 1, 1, 1, 9, 8, 14, 15, 8, 9, 8, 9, 9, 8, 9, 9, 9, 8, 9, 2, 3, 7, 1, 1, 1, 1, 1, 1, 9, 8, 9, 8, 9, 8, 9, 8, 9, 8, 
 8, 9, 8, 9, 8, 9, 8, 9, 8, 9, 1, 1, 1, 1, 1, 1, 1, 1, 1, 1, 1, 1, 1, 1, 1, 1, 1, 1, 1, 1, 1, 1, 1, 1, 1, 1, 1, 1, 1, 1, 8, 9, 8, 1, 1, 1, 8, 9, 8, 9, 8, 8, 1, 1, 1, 1, 8, 8, 8, 9, 8, 9, 8, 9, 2, 3, 7, 1, 1, 1, 8, 9, 8, 9, 8, 9, 8, 9, 8, 9, 
 9, 8, 9, 8, 9, 8, 9, 8, 9, 8, 1, 1, 1, 1, 1, 1, 1, 1, 1, 1, 1, 1, 1, 1, 1, 1, 1, 1, 1, 1, 1, 1, 1, 1, 1, 1, 1, 1, 1, 1, 8, 9, 8, 1, 1, 1, 9, 8, 9, 8, 9, 1, 1, 1, 1, 1, 1, 1, 1, 1, 1, 8, 9, 8, 9, 8, 9, 1, 1, 1, 9, 8, 9, 8, 9, 8, 9, 8, 9, 8, 
 8, 9, 8, 9, 8, 9, 8, 9, 8, 9, 1, 1, 1, 1, 1, 1, 1, 1, 1, 1, 1, 1, 1, 1, 1, 1, 1, 1, 1, 1, 1, 1, 1, 1, 1, 1, 1, 1, 1, 1, 9, 8, 9, 1, 1, 1, 8, 9, 8, 9, 8, 1, 1, 1, 1, 1, 1, 1, 1, 1, 1, 1, 1, 1, 8, 9, 8, 1, 1, 1, 8, 9, 8, 9, 8, 9, 8, 9, 8, 9, 
 9, 8, 9, 8, 9, 8, 9, 8, 9, 8, 2, 3, 4, 5, 6, 7, 2, 3, 4, 5, 6, 7, 2, 3, 4, 5, 6, 7, 2, 3, 4, 5, 6, 7, 2, 7, 1, 1, 1, 2, 9, 8, 8, 1, 1, 1, 8, 9, 8, 1, 1, 1, 1, 1, 1, 1, 1, 1, 1, 1, 1, 1, 1, 1, 1, 1, 1, 1, 1, 1, 9, 8, 9, 8, 9, 8, 9, 8, 9, 8, 
 8, 9, 8, 9, 8, 9, 8, 9, 8, 9, 8, 9, 9, 8, 9, 9, 8, 9, 9, 8, 9, 9, 8, 9, 9, 8, 9, 9, 8, 9, 9, 8, 9, 9, 8, 9, 1, 1, 1, 9, 8, 9, 8, 1, 1, 1, 9, 8, 9, 1, 1, 1, 1, 1, 1, 1, 1, 1, 1, 1, 1, 1, 1, 1, 1, 1, 1, 1, 1, 1, 8, 9, 8, 9, 8, 9, 8, 9, 8, 9, 
 9, 8, 9, 8, 9, 8, 9, 8, 9, 8, 9, 8, 8, 9, 8, 8, 9, 8, 8, 9, 8, 8, 9, 8, 8, 9, 8, 8, 9, 8, 8, 9, 8, 8, 9, 8, 1, 1, 1, 8, 9, 8, 9, 1, 1, 1, 8, 9, 8, 1, 1, 1, 1, 1, 1, 1, 1, 1, 1, 1, 1, 1, 1, 1, 1, 1, 1, 1, 1, 1, 9, 8, 9, 8, 9, 8, 9, 8, 9, 8, 
 8, 9, 8, 9, 8, 9, 8, 9, 8, 9, 1, 1, 1, 1, 1, 1, 1, 1, 1, 1, 1, 1, 1, 1, 1, 1, 1, 1, 1, 1, 1, 1, 1, 1, 1, 1, 1, 1, 1, 1, 8, 9, 8, 1, 1, 1, 8, 9, 8, 2, 3, 7, 1, 1, 1, 2, 3, 4, 5, 6, 7, 2, 3, 4, 5, 6, 7, 2, 3, 7, 8, 9, 8, 9, 8, 9, 8, 9, 8, 9, 
 9, 8, 9, 8, 9, 8, 9, 8, 9, 8, 1, 1, 1, 1, 1, 1, 1, 1, 1, 1, 1, 1, 1, 1, 1, 1, 1, 1, 1, 1, 1, 1, 1, 1, 1, 1, 1, 1, 1, 1, 8, 9, 8, 1, 1, 1, 9, 8, 9, 9, 8, 9, 1, 1, 1, 9, 8, 9, 9, 8, 9, 9, 8, 9, 9, 8, 9, 9, 8, 9, 9, 8, 9, 8, 9, 8, 9, 8, 9, 8, 
 8, 9, 8, 9, 8, 9, 8, 9, 8, 9, 1, 1, 1, 1, 1, 1, 1, 1, 1, 1, 1, 1, 1, 1, 1, 1, 1, 1, 1, 1, 1, 1, 1, 1, 1, 1, 1, 1, 1, 1, 9, 8, 9, 1, 1, 1, 8, 9, 8, 8, 9, 8, 1, 1, 1, 8, 9, 8, 8, 9, 8, 8, 9, 8, 8, 9, 8, 8, 9, 8, 8, 9, 8, 9, 8, 9, 8, 9, 8, 9, 
 9, 8, 9, 8, 9, 8, 9, 8, 9, 8, 1, 1, 1, 1, 1, 1, 1, 1, 1, 1, 1, 1, 1, 1, 1, 1, 1, 1, 1, 1, 1, 1, 1, 1, 2, 3, 4, 5, 6, 7, 8, 9, 8, 1, 1, 1, 8, 9, 8, 8, 9, 8, 1, 1, 1, 1, 1, 1, 1, 1, 1, 1, 1, 1, 1, 1, 1, 1, 1, 1, 9, 8, 9, 8, 9, 8, 9, 8, 9, 8, 
 8, 9, 8, 9, 8, 9, 8, 9, 8, 9, 1, 1, 1, 1, 1, 1, 1, 1, 1, 1, 1, 1, 1, 1, 1, 1, 1, 1, 1, 1, 1, 2, 3, 7, 9, 8, 9, 9, 8, 9, 8, 9, 8, 1, 1, 1, 9, 8, 9, 9, 8, 9, 1, 1, 1, 1, 1, 1, 1, 1, 1, 1, 1, 1, 1, 1, 1, 1, 1, 1, 8, 9, 8, 9, 8, 9, 8, 9, 8, 9, 
 9, 8, 9, 8, 9, 8, 9, 8, 9, 8, 1, 1, 1, 1, 1, 1, 1, 1, 1, 1, 1, 1, 1, 1, 1, 1, 1, 1, 2, 3, 7, 9, 8, 9, 8, 9, 8, 8, 9, 8, 9, 8, 9, 1, 1, 1, 8, 9, 8, 8, 9, 8, 1, 1, 1, 1, 1, 1, 1, 1, 1, 1, 1, 1, 1, 1, 1, 1, 1, 1, 9, 8, 9, 8, 9, 8, 9, 8, 9, 8, 
 8, 9, 8, 9, 8, 9, 8, 9, 8, 9, 1, 1, 1, 1, 1, 1, 1, 1, 1, 1, 1, 1, 1, 1, 1, 2, 3, 7, 8, 8, 9, 8, 9, 8, 1, 1, 1, 1, 1, 1, 8, 9, 8, 1, 1, 1, 8, 9, 8, 9, 8, 9, 2, 3, 7, 1, 1, 1, 1, 1, 1, 1, 1, 1, 1, 1, 1, 1, 1, 1, 8, 9, 8, 9, 8, 9, 8, 9, 8, 9, 
 9, 8, 9, 8, 9, 8, 9, 8, 9, 8, 1, 1, 1, 1, 1, 1, 1, 1, 1, 1, 1, 1, 1, 1, 2, 9, 8, 9, 9, 9, 8, 1, 1, 1, 1, 1, 1, 1, 1, 1, 8, 9, 8, 1, 1, 1, 9, 8, 9, 8, 9, 8, 9, 8, 9, 2, 3, 7, 1, 1, 1, 1, 1, 1, 1, 1, 1, 1, 1, 1, 9, 8, 9, 8, 9, 8, 9, 8, 9, 8, 
 8, 9, 8, 9, 8, 9, 8, 9, 8, 9, 1, 1, 1, 1, 1, 1, 1, 1, 1, 1, 1, 1, 1, 2, 9, 8, 9, 8, 8, 1, 1, 1, 1, 1, 1, 1, 1, 1, 1, 1, 9, 8, 9, 1, 1, 1, 8, 9, 8, 8, 9, 8, 8, 9, 8, 9, 8, 8, 2, 7, 1, 1, 1, 1, 1, 1, 1, 1, 1, 1, 8, 9, 8, 9, 8, 9, 8, 9, 8, 9, 
 9, 8, 9, 8, 9, 8, 9, 8, 9, 8, 1, 1, 1, 1, 1, 1, 1, 1, 1, 1, 1, 2, 7, 8, 8, 9, 8, 1, 1, 1, 1, 1, 1, 1, 1, 1, 1, 1, 1, 1, 8, 9, 8, 1, 1, 1, 8, 9, 8, 9, 8, 9, 8, 9, 8, 8, 9, 9, 8, 9, 2, 1, 1, 1, 1, 1, 1, 1, 1, 1, 9, 8, 9, 8, 9, 8, 9, 8, 9, 8, 
 8, 9, 8, 9, 8, 9, 8, 9, 8, 9, 2, 3, 4, 5, 6, 1, 1, 1, 2, 3, 7, 9, 8, 9, 9, 8, 1, 1, 1, 1, 1, 1, 1, 1, 1, 1, 1, 1, 1, 1, 8, 9, 8, 1, 1, 1, 9, 8, 9, 8, 9, 8, 9, 8, 9, 8, 9, 8, 9, 8, 9, 1, 1, 1, 1, 1, 1, 1, 1, 1, 8, 9, 8, 9, 8, 9, 8, 9, 8, 9, 
 9, 8, 9, 8, 9, 8, 9, 8, 9, 8, 9, 8, 9, 9, 8, 1, 1, 1, 9, 8, 9, 8, 9, 8, 1, 1, 1, 1, 1, 1, 1, 1, 1, 1, 1, 1, 1, 1, 1, 1, 9, 8, 9, 1, 1, 1, 8, 9, 8, 8, 9, 8, 8, 9, 8, 9, 8, 9, 8, 8, 9, 2, 1, 1, 1, 1, 1, 1, 1, 1, 9, 8, 9, 8, 9, 8, 9, 8, 9, 8, 
 8, 9, 8, 9, 8, 9, 8, 9, 8, 9, 8, 9, 8, 8, 1, 1, 1, 1, 1, 9, 8, 1, 1, 1, 1, 1, 1, 1, 1, 1, 1, 1, 1, 1, 1, 1, 1, 1, 1, 1, 8, 9, 8, 1, 1, 1, 8, 9, 8, 9, 8, 9, 8, 9, 8, 8, 9, 8, 9, 8, 8, 9, 1, 1, 1, 1, 1, 1, 1, 1, 8, 9, 8, 9, 8, 9, 8, 9, 8, 9, 
 9, 8, 9, 8, 9, 8, 9, 8, 9, 8, 1, 1, 1, 1, 1, 1, 1, 1, 1, 1, 1, 1, 1, 1, 1, 1, 1, 1, 1, 1, 1, 1, 1, 1, 1, 1, 1, 1, 1, 1, 8, 9, 8, 1, 1, 1, 9, 8, 9, 8, 9, 8, 9, 8, 9, 8, 9, 9, 8, 9, 9, 8, 1, 1, 1, 1, 1, 1, 1, 1, 9, 8, 9, 8, 9, 8, 9, 8, 9, 8, 
 8, 9, 8, 9, 8, 9, 8, 9, 8, 9, 1, 1, 1, 1, 1, 1, 1, 1, 1, 1, 1, 1, 1, 1, 1, 1, 1, 1, 1, 1, 1, 1, 1, 1, 1, 1, 1, 1, 1, 1, 9, 8, 9, 1, 1, 1, 8, 9, 8, 8, 9, 8, 8, 9, 8, 9, 8, 8, 9, 8, 9, 8, 2, 3, 7, 1, 1, 1, 1, 1, 8, 9, 8, 9, 8, 9, 8, 9, 8, 9, 
 9, 8, 9, 8, 9, 8, 9, 8, 9, 8, 1, 1, 1, 1, 1, 1, 1, 1, 1, 1, 1, 1, 1, 1, 1, 1, 1, 1, 1, 1, 1, 1, 1, 1, 1, 1, 1, 1, 1, 1, 8, 9, 8, 1, 1, 1, 8, 9, 8, 9, 8, 9, 8, 8, 9, 8, 8, 9, 8, 9, 8, 9, 9, 8, 9, 1, 1, 1, 1, 1, 9, 8, 9, 8, 9, 8, 9, 8, 9, 8, 
 8, 9, 8, 9, 8, 9, 8, 9, 8, 9, 1, 1, 1, 1, 1, 1, 1, 1, 1, 1, 1, 1, 1, 1, 1, 1, 1, 1, 1, 1, 1, 1, 1, 1, 1, 1, 1, 1, 1, 1, 8, 9, 8, 1, 1, 1, 9, 8, 9, 8, 9, 8, 9, 9, 8, 9, 9, 8, 9, 8, 9, 8, 8, 9, 8, 1, 1, 1, 1, 1, 8, 9, 8, 9, 8, 9, 8, 9, 8, 9, 
 9, 8, 9, 8, 9, 8, 9, 8, 9, 8, 1, 1, 1, 1, 1, 2, 3, 4, 1, 1, 1, 2, 3, 4, 1, 1, 1, 2, 3, 4, 1, 1, 1, 2, 3, 4, 1, 1, 1, 1, 9, 8, 9, 1, 1, 1, 8, 9, 8, 9, 8, 9, 8, 8, 9, 8, 8, 1, 1, 1, 1, 1, 1, 1, 1, 1, 1, 1, 1, 1, 9, 8, 9, 8, 9, 8, 9, 8, 9, 8, 
 8, 9, 8, 9, 8, 9, 8, 9, 8, 9, 1, 1, 1, 1, 1, 9, 8, 9, 1, 1, 1, 9, 8, 9, 1, 1, 1, 9, 8, 9, 1, 1, 1, 9, 8, 9, 1, 1, 1, 1, 8, 9, 8, 1, 1, 1, 8, 9, 8, 8, 9, 8, 1, 1, 1, 1, 1, 1, 1, 1, 1, 1, 1, 1, 1, 1, 1, 1, 1, 1, 8, 9, 8, 9, 8, 9, 8, 9, 8, 9, 
 9, 8, 9, 8, 9, 8, 9, 8, 9, 8, 1, 1, 1, 1, 1, 8, 9, 8, 1, 1, 1, 8, 9, 8, 1, 1, 1, 8, 9, 8, 1, 1, 1, 8, 9, 8, 1, 1, 1, 1, 8, 9, 8, 1, 1, 1, 9, 8, 9, 1, 1, 1, 1, 1, 1, 1, 1, 1, 1, 1, 1, 1, 1, 1, 1, 1, 1, 1, 1, 1, 9, 8, 9, 8, 9, 8, 9, 8, 9, 8, 
 8, 9, 8, 9, 8, 9, 8, 9, 8, 9, 1, 1, 1, 1, 1, 1, 1, 1, 1, 1, 1, 1, 1, 1, 1, 1, 1, 1, 1, 1, 1, 1, 1, 1, 1, 1, 1, 1, 1, 1, 9, 8, 9, 1, 1, 1, 8, 9, 8, 1, 1, 1, 1, 1, 1, 1, 1, 1, 2, 3, 4, 7, 1, 1, 1, 2, 3, 4, 5, 7, 8, 9, 8, 9, 8, 9, 8, 9, 8, 9, 
 9, 8, 9, 8, 9, 8, 9, 8, 9, 8, 1, 1, 1, 1, 1, 1, 1, 1, 1, 1, 1, 1, 1, 1, 1, 1, 1, 1, 1, 1, 1, 1, 1, 1, 1, 1, 1, 1, 1, 1, 8, 9, 8, 1, 1, 1, 8, 9, 8, 1, 1, 1, 1, 1, 1, 1, 2, 7, 9, 8, 9, 9, 1, 1, 1, 9, 8, 9, 8, 9, 9, 8, 9, 8, 9, 8, 9, 8, 9, 8, 
 8, 9, 8, 9, 8, 9, 8, 9, 8, 9, 1, 1, 1, 1, 1, 1, 1, 1, 1, 1, 1, 1, 1, 1, 1, 1, 1, 1, 1, 1, 1, 1, 1, 1, 1, 1, 1, 1, 1, 1, 8, 9, 8, 1, 1, 1, 9, 8, 9, 1, 1, 1, 1, 1, 2, 7, 8, 8, 8, 9, 8, 8, 1, 1, 1, 8, 9, 8, 9, 8, 8, 9, 8, 9, 8, 9, 8, 9, 8, 9, 
 9, 8, 9, 8, 9, 8, 9, 8, 9, 8, 1, 1, 1, 1, 1, 1, 1, 1, 1, 1, 1, 1, 1, 1, 1, 1, 1, 1, 1, 1, 1, 1, 1, 1, 1, 1, 1, 2, 3, 4, 9, 8, 9, 1, 1, 1, 8, 9, 8, 1, 1, 1, 2, 7, 8, 8, 9, 9, 8, 1, 1, 1, 1, 1, 1, 1, 8, 9, 8, 9, 8, 8, 9, 8, 9, 8, 9, 8, 9, 8, 
 8, 9, 8, 9, 8, 9, 8, 9, 8, 9, 1, 1, 1, 1, 1, 1, 1, 1, 1, 1, 1, 1, 1, 1, 1, 1, 1, 1, 1, 1, 1, 1, 1, 1, 1, 1, 1, 9, 8, 9, 8, 9, 8, 1, 1, 1, 8, 9, 8, 1, 1, 1, 8, 9, 8, 9, 8, 1, 1, 1, 1, 1, 1, 1, 1, 1, 1, 8, 9, 8, 9, 9, 8, 9, 8, 9, 8, 9, 8, 9, 
 9, 8, 9, 8, 9, 8, 9, 8, 9, 8, 1, 1, 1, 1, 1, 1, 1, 1, 1, 1, 1, 1, 1, 1, 1, 1, 1, 1, 1, 1, 1, 1, 1, 1, 1, 1, 1, 8, 9, 8, 8, 9, 8, 1, 1, 1, 9, 8, 9, 1, 1, 1, 9, 8, 9, 1, 1, 1, 1, 1, 1, 1, 1, 1, 1, 1, 1, 1, 8, 9, 8, 8, 9, 8, 9, 8, 9, 8, 9, 8, 
 8, 9, 8, 9, 8, 9, 8, 9, 8, 9, 1, 1, 1, 1, 1, 1, 1, 1, 1, 1, 1, 1, 1, 1, 1, 1, 1, 1, 1, 1, 1, 1, 1, 1, 1, 1, 1, 1, 1, 1, 9, 8, 9, 1, 1, 1, 8, 9, 8, 1, 1, 1, 8, 9, 8, 1, 1, 1, 1, 1, 1, 1, 1, 1, 1, 1, 1, 1, 1, 9, 8, 9, 8, 9, 8, 9, 8, 9, 8, 9, 
 9, 8, 9, 8, 9, 8, 9, 8, 9, 8, 1, 1, 1, 1, 1, 1, 1, 1, 1, 1, 1, 1, 1, 1, 1, 1, 1, 1, 1, 1, 1, 1, 1, 1, 1, 1, 1, 1, 1, 1, 8, 9, 8, 1, 1, 1, 1, 1, 1, 1, 1, 1, 1, 1, 1, 1, 1, 1, 1, 1, 1, 1, 1, 1, 1, 1, 1, 1, 1, 8, 9, 8, 9, 8, 9, 8, 9, 8, 9, 8, 
 8, 9, 8, 9, 8, 9, 8, 9, 8, 9, 1, 1, 1, 1, 1, 1, 1, 1, 1, 1, 1, 1, 1, 1, 1, 1, 1, 1, 1, 1, 1, 1, 1, 2, 3, 7, 1, 1, 1, 1, 9, 8, 9, 1, 1, 1, 1, 1, 1, 1, 1, 1, 1, 1, 1, 1, 1, 1, 1, 2, 3, 4, 5, 6, 7, 1, 1, 1, 1, 1, 8, 9, 8, 9, 8, 9, 8, 9, 8, 9, 
 9, 8, 9, 8, 9, 8, 9, 8, 9, 8, 1, 1, 1, 1, 1, 1, 1, 1, 1, 1, 1, 1, 1, 1, 1, 1, 1, 1, 1, 1, 1, 1, 1, 9, 8, 9, 1, 1, 1, 1, 8, 9, 8, 1, 1, 1, 1, 1, 1, 1, 1, 1, 1, 1, 1, 1, 1, 2, 7, 9, 8, 9, 9, 8, 9, 7, 1, 1, 1, 1, 9, 8, 9, 8, 9, 8, 9, 8, 9, 8, 
 8, 9, 8, 9, 8, 9, 8, 9, 8, 9, 1, 1, 1, 1, 1, 1, 1, 1, 1, 1, 1, 1, 1, 1, 1, 1, 1, 1, 1, 1, 1, 1, 1, 8, 9, 8, 1, 1, 1, 1, 8, 9, 8, 2, 3, 4, 5, 6, 7, 1, 1, 1, 2, 3, 4, 5, 7, 9, 8, 8, 9, 8, 8, 9, 8, 9, 1, 1, 1, 1, 8, 9, 8, 9, 8, 9, 8, 9, 8, 9, 
 9, 8, 9, 8, 9, 8, 9, 8, 9, 8, 1, 1, 1, 1, 1, 1, 1, 1, 1, 1, 1, 1, 1, 1, 1, 1, 1, 1, 1, 1, 1, 1, 1, 1, 1, 1, 1, 1, 1, 1, 9, 8, 9, 9, 8, 9, 9, 8, 9, 1, 1, 1, 9, 8, 9, 9, 8, 8, 9, 8, 1, 1, 1, 1, 1, 1, 1, 1, 1, 1, 9, 8, 9, 8, 9, 8, 9, 8, 9, 8, 
 8, 9, 8, 9, 8, 9, 8, 9, 8, 9, 1, 1, 1, 1, 1, 1, 1, 1, 1, 1, 1, 1, 1, 1, 1, 1, 1, 1, 1, 1, 1, 1, 1, 1, 1, 1, 1, 1, 1, 1, 8, 9, 8, 8, 9, 8, 8, 9, 8, 1, 1, 1, 8, 9, 8, 8, 9, 8, 1, 1, 1, 1, 1, 1, 1, 1, 1, 1, 1, 1, 8, 9, 8, 9, 8, 9, 8, 9, 8, 9, 
 9, 8, 9, 8, 9, 8, 9, 8, 9, 8, 1, 1, 1, 1, 1, 1, 1, 1, 1, 1, 1, 1, 1, 1, 1, 1, 1, 1, 1, 1, 1, 1, 1, 1, 1, 1, 1, 1, 1, 2, 9, 8, 9, 1, 1, 1, 1, 1, 1, 1, 1, 1, 1, 1, 1, 1, 1, 1, 1, 1, 1, 1, 1, 1, 1, 1, 1, 1, 1, 2, 9, 8, 9, 8, 9, 8, 9, 8, 9, 8, 
 8, 9, 8, 9, 8, 9, 8, 9, 8, 9, 1, 1, 1, 1, 1, 1, 1, 1, 1, 1, 1, 1, 1, 1, 1, 1, 1, 1, 1, 1, 1, 1, 1, 1, 2, 3, 4, 5, 7, 9, 8, 9, 8, 1, 1, 1, 1, 1, 1, 1, 1, 1, 1, 1, 1, 1, 1, 1, 1, 1, 1, 1, 1, 2, 3, 4, 5, 6, 7, 9, 8, 9, 8, 9, 8, 9, 8, 9, 8, 9, 
 9, 8, 9, 8, 9, 8, 9, 8, 9, 8, 1, 1, 1, 1, 1, 1, 1, 1, 1, 1, 1, 1, 1, 1, 1, 1, 1, 1, 1, 1, 1, 1, 2, 7, 8, 8, 9, 9, 8, 8, 9, 8, 1, 1, 1, 1, 1, 1, 1, 1, 1, 1, 1, 1, 1, 1, 1, 1, 1, 1, 2, 3, 7, 9, 8, 9, 9, 9, 8, 8, 9, 8, 9, 8, 9, 8, 9, 8, 9, 8, 
 8, 9, 8, 9, 8, 9, 8, 9, 8, 9, 1, 1, 1, 1, 1, 1, 1, 1, 1, 1, 1, 1, 1, 1, 1, 1, 1, 1, 1, 1, 1, 1, 9, 8, 9, 9, 8, 8, 9, 8, 1, 1, 1, 1, 1, 1, 2, 3, 4, 5, 6, 7, 2, 3, 4, 5, 6, 7, 2, 7, 9, 8, 9, 8, 9, 8, 8, 8, 9, 8, 8, 9, 8, 9, 8, 9, 8, 9, 8, 9, 
 9, 8, 9, 8, 9, 8, 9, 8, 9, 8, 1, 1, 1, 1, 1, 1, 1, 1, 1, 1, 1, 1, 1, 1, 1, 1, 1, 1, 1, 1, 1, 1, 8, 9, 8, 8, 1, 1, 1, 1, 1, 1, 1, 1, 1, 1, 9, 8, 9, 9, 8, 9, 9, 9, 8, 9, 9, 9, 8, 9, 8, 9, 8, 1, 1, 1, 1, 1, 1, 1, 9, 8, 9, 8, 9, 8, 9, 8, 9, 8, 
 8, 9, 8, 9, 8, 9, 8, 9, 8, 9, 1, 1, 1, 1, 1, 1, 1, 1, 1, 1, 1, 1, 1, 1, 1, 1, 1, 1, 1, 1, 1, 1, 1, 1, 1, 1, 1, 1, 1, 1, 1, 1, 1, 1, 1, 1, 8, 9, 8, 8, 9, 8, 8, 8, 9, 8, 8, 8, 9, 8, 1, 1, 1, 1, 1, 1, 1, 1, 1, 1, 8, 9, 8, 9, 8, 9, 8, 9, 8, 9, 
 9, 8, 9, 8, 9, 8, 9, 8, 9, 8, 1, 1, 1, 1, 1, 1, 1, 1, 1, 1, 1, 1, 1, 1, 1, 1, 1, 1, 1, 1, 1, 1, 1, 1, 1, 1, 1, 1, 1, 1, 1, 1, 1, 1, 1, 1, 1, 1, 1, 1, 1, 1, 1, 1, 1, 1, 1, 1, 1, 1, 1, 1, 1, 1, 1, 1, 1, 1, 1, 1, 9, 8, 9, 8, 9, 8, 9, 8, 9, 8, 
 8, 9, 8, 9, 8, 9, 8, 9, 8, 9, 1, 1, 1, 1, 1, 1, 1, 1, 1, 1, 2, 3, 4, 5, 6, 7, 2, 3, 7, 1, 1, 1, 1, 1, 1, 1, 1, 1, 1, 1, 1, 1, 1, 1, 1, 1, 1, 1, 1, 1, 1, 1, 1, 1, 1, 1, 1, 1, 1, 1, 1, 1, 1, 1, 1, 1, 1, 1, 1, 1, 8, 9, 8, 9, 8, 9, 8, 9, 8, 9, 
 9, 8, 9, 8, 9, 8, 9, 8, 9, 8, 1, 1, 1, 1, 1, 1, 1, 1, 2, 7, 9, 8, 9, 8, 9, 8, 9, 8, 9, 2, 3, 7, 1, 1, 1, 1, 1, 1, 1, 1, 1, 1, 1, 1, 1, 1, 1, 1, 1, 1, 1, 1, 1, 1, 1, 1, 1, 1, 1, 1, 1, 1, 1, 1, 1, 1, 1, 1, 1, 1, 9, 8, 9, 8, 9, 8, 9, 8, 9, 8, 
 8, 9, 8, 9, 8, 9, 8, 9, 8, 9, 1, 1, 1, 1, 1, 1, 2, 7, 8, 9, 8, 9, 8, 9, 8, 9, 8, 9, 8, 9, 8, 9, 2, 7, 1, 1, 1, 1, 1, 1, 1, 1, 1, 1, 1, 1, 1, 1, 1, 1, 1, 1, 1, 1, 1, 1, 1, 1, 1, 1, 1, 1, 1, 1, 1, 1, 1, 1, 1, 1, 8, 9, 8, 9, 8, 9, 8, 9, 8, 9, 
 9, 8, 9, 8, 9, 8, 9, 8, 9, 8, 2, 3, 4, 5, 6, 7, 8, 9, 8, 9, 8, 9, 8, 9, 8, 9, 8, 9, 8, 9, 8, 9, 8, 9, 2, 3, 4, 5, 6, 7, 2, 3, 4, 5, 6, 7, 2, 3, 4, 5, 6, 7, 2, 3, 4, 5, 6, 7, 2, 3, 4, 5, 6, 7, 2, 3, 4, 5, 6, 7, 8, 9, 8, 9, 8, 9, 8, 9, 8, 9, 
 8, 9, 8, 9, 8, 9, 8, 9, 8, 9, 9, 8, 9, 8, 9, 8, 9, 8, 9, 8, 9, 8, 9, 8, 9, 8, 9, 8, 9, 8, 9, 8, 9, 8, 9, 8, 9, 8, 9, 8, 9, 8, 9, 8, 9, 8, 9, 8, 9, 8, 9, 8, 9, 8, 9, 8, 9, 8, 9, 8, 9, 8, 9, 8, 9, 8, 9, 8, 9, 8, 9, 8, 9, 8, 9, 8, 9, 8, 9, 8, 
 9, 8, 9, 8, 9, 8, 9, 8, 9, 8, 8, 9, 8, 9, 8, 9, 8, 9, 8, 9, 8, 9, 8, 9, 8, 9, 8, 9, 8, 9, 8, 9, 8, 9, 8, 9, 8, 9, 8, 9, 8, 9, 8, 9, 8, 9, 8, 9, 8, 9, 8, 9, 8, 9, 8, 9, 8, 9, 8, 9, 8, 9, 8, 9, 8, 9, 8, 9, 8, 9, 8, 9, 8, 9, 8, 9, 8, 9, 8, 9, 
 8, 9, 8, 9, 8, 9, 8, 9, 8, 9, 9, 8, 9, 8, 9, 8, 9, 8, 9, 8, 9, 8, 9, 8, 9, 8, 9, 8, 9, 8, 9, 8, 9, 8, 9, 8, 9, 8, 9, 8, 9, 8, 9, 8, 9, 8, 9, 8, 9, 8, 9, 8, 9, 8, 9, 8, 9, 8, 9, 8, 9, 8, 9, 8, 9, 8, 9, 8, 9, 8, 9, 8, 9, 8, 9, 8, 9, 8, 9, 8, 
 9, 8, 9, 8, 9, 8, 9, 8, 9, 8, 8, 9, 8, 9, 8, 9, 8, 9, 8, 9, 8, 9, 8, 9, 8, 9, 8, 9, 8, 9, 8, 9, 8, 9, 8, 9, 8, 9, 8, 9, 8, 9, 8, 9, 8, 9, 8, 9, 8, 9, 8, 9, 8, 9, 8, 9, 8, 9, 8, 9, 8, 9, 8, 9, 8, 9, 8, 9, 8, 9, 8, 9, 8, 9, 8, 9, 8, 9, 8, 9, 
 8, 9, 8, 9, 8, 9, 8, 9, 8, 9, 9, 8, 9, 8, 9, 8, 9, 8, 9, 8, 9, 8, 9, 8, 9, 8, 9, 8, 9, 8, 9, 8, 9, 8, 9, 8, 9, 8, 9, 8, 9, 8, 9, 8, 9, 8, 9, 8, 9, 8, 9, 8, 9, 8, 9, 8, 9, 8, 9, 8, 9, 8, 9, 8, 9, 8, 9, 8, 9, 8, 9, 8, 9, 8, 9, 8, 9, 8, 9, 8, 
 9, 8, 9, 8, 9, 8, 9, 8, 9, 8, 8, 9, 8, 9, 8, 9, 8, 9, 8, 9, 8, 9, 8, 9, 8, 9, 8, 9, 8, 9, 8, 9, 8, 9, 8, 9, 8, 9, 8, 9, 8, 9, 8, 9, 8, 9, 8, 9, 8, 9, 8, 9, 8, 9, 8, 9, 8, 9, 8, 9, 8, 9, 8, 9, 8, 9, 8, 9, 8, 9, 8, 9, 8, 9, 8, 9, 8, 9, 8, 9, 
