DATA "A:\LEVELS\1.LVL"
DATA "0000000000000000"
DATA "0000000000000000"
DATA "0000000000000000"
DATA "0000000000000000"
DATA "0000000000000000"
DATA "0000000000000000"
DATA "0000000000000000"
DATA "0000000000000000"
DATA "0000000000000000"
DATA "0000000000000000"
DATA "0000000000000000"
DATA "0000000000000000"
DATA "0000000000000000"
DATA "0000000000000000"
DATA "0000000000000000"
DATA "0000000000000000"
DATA "0000000000000000"
DATA "0000000000000000"
DATA "1000000000000100"
DATA "1100000000001100"
DATA "1110000000011100"
DATA "1111000000111100"
DATA "1111100001111100"
DATA "1111110011111100"
