DATA "A:\LEVELS\11.LVL"
DATA "0000000000000000"
DATA "0000000000000000"
DATA "0000000000000000"
DATA "0000000000000000"
DATA "0000000000000000"
DATA "0000000000000000"
DATA "0000000000000000"
DATA "0000000000000000"
DATA "0000000000000000"
DATA "0000000000000000"
DATA "0000000000000000"
DATA "0000000000000000"
DATA "0000000000000000"
DATA "0111111111111000"
DATA "0222222222222000"
DATA "0111111111111000"
DATA "0222222222222000"
DATA "0111111111111000"
DATA "0222222222222000"
DATA "0111111111111000"
DATA "0222222222222000"
DATA "0111111111111000"
DATA "0222222222222000"
DATA "0111111111111000"
