DATA "A:\LEVELS\14.LVL"
DATA "0000000000000000"
DATA "0000000000000000"
DATA "1111200002111100"
DATA "1111200002111100"
DATA "1111200002111100"
DATA "1111200002111100"
DATA "2222200002222200"
DATA "0000000000000000"
DATA "0000000000000000"
DATA "0000000000000000"
DATA "0000000000000000"
DATA "1111200002111100"
DATA "1111200002111100"
DATA "1111200002111100"
DATA "1111200002111100"
DATA "2222200002222200"
DATA "0000000000000000"
DATA "0000000000000000"
DATA "0000000000000000"
DATA "0000000000000000"
DATA "1111200002111100"
DATA "1111200002111100"
DATA "1111200002111100"
DATA "1111200002111100"
