DATA "A:\LEVELS\15.LVL"
DATA "2222200002222200"
DATA "2222200002222200"
DATA "2222200002222200"
DATA "2222200002222200"
DATA "2222000000222200"
DATA "2222000000222200"
DATA "2220000000022200"
DATA "2220000000022200"
DATA "2200002200002200"
DATA "2200002200002200"
DATA "2200002220000200"
DATA "2200002220000200"
DATA "2000022200002200"
DATA "2000022200002200"
DATA "0000222000002200"
DATA "0000222000000200"
DATA "0002220000000200"
DATA "0002220000000000"
DATA "0022200002000000"
DATA "0022200002000000"
DATA "0222000022200000"
DATA "0222000022200000"
DATA "2220000222220000"
DATA "2220000222220000"
