DATA "A:\LEVELS\16.LVL"
DATA "0000000000000000"
DATA "0000000000000000"
DATA "0000000000000000"
DATA "0000000000000000"
DATA "0000000000000000"
DATA "0000000000000000"
DATA "0000000000000000"
DATA "0000000000000000"
DATA "0000000000000000"
DATA "0000000000000000"
DATA "0000000000000000"
DATA "0000000000000000"
DATA "1210121012101200"
DATA "1210121012101200"
DATA "0101010101010100"
DATA "0101010101010100"
DATA "1012101210121000"
DATA "1012101210121000"
DATA "0101010101010100"
DATA "0101010101010100"
DATA "1210121012101200"
DATA "1210121012101200"
DATA "0101010101010100"
DATA "0101010101010100"
