DATA "A:\LEVELS\3.LVL"
DATA "0000000000000000"
DATA "0000000000000100"
DATA "0000000000001100"
DATA "0000000000011100"
DATA "0000000000001100"
DATA "0000000000000100"
DATA "1000000000000000"
DATA "1100000000000000"
DATA "1110000000000000"
DATA "1100000000000000"
DATA "1000000000000000"
DATA "0000000000000100"
DATA "0000000000001100"
DATA "0000000000011100"
DATA "0000000000001100"
DATA "0000000000000100"
DATA "1000000000000000"
DATA "1100000000000000"
DATA "1110000000000000"
DATA "1100000000000100"
DATA "1000000000001100"
DATA "0000000000011100"
DATA "0000000000001100"
DATA "0000000000000100"
