DATA "A:\LEVELS\4.LVL"
DATA "1100000000000100"
DATA "1000000000001100"
DATA "0000000000011100"
DATA "0000000000111100"
DATA "0000000000011100"
DATA "1000000000001100"
DATA "1100000000000100"
DATA "1110000000000000"
DATA "1111000000000000"
DATA "1110000000000000"
DATA "1100000000000100"
DATA "1000000000001100"
DATA "0000000000011100"
DATA "0000000000111100"
DATA "0000000000011100"
DATA "1000000000001100"
DATA "1100000000000100"
DATA "1110000000000000"
DATA "1111000000000000"
DATA "1110000000000000"
DATA "1100000000000100"
DATA "1000000000001100"
DATA "0000000000011100"
DATA "0000000000111100"
