DATA "A:\LEVELS\5.LVL"
DATA "0000000000000000"
DATA "0000000000000000"
DATA "0000000000000000"
DATA "0000000000000000"
DATA "0000000000000000"
DATA "0000000000000000"
DATA "0001000000100000"
DATA "0011100001110000"
DATA "0111110011111000"
DATA "0011100001110000"
DATA "0001000000100000"
DATA "0000000000000000"
DATA "0001000000100000"
DATA "0011100001110000"
DATA "0111110011111000"
DATA "0011100001110000"
DATA "0001000000100000"
DATA "0000000000000000"
DATA "0001000000100000"
DATA "0011100001110000"
DATA "0111110011111000"
DATA "0011100001110000"
DATA "0001000000100000"
DATA "0000000000000000"
