DATA "A:\LEVELS\6.LVL"
DATA "1111100001111100"
DATA "1111100001111100"
DATA "1111100001111100"
DATA "1111100001111100"
DATA "0000000000000000"
DATA "1111000000111100"
DATA "0000000000000000"
DATA "1111000000111100"
DATA "0000000000000000"
DATA "1111000000111100"
DATA "0000000000000000"
DATA "1111000000111100"
DATA "0000000000000000"
DATA "1111000000111100"
DATA "0000000000000000"
DATA "1111000000111100"
DATA "0000000000000000"
DATA "1111000000111100"
DATA "0000000000000000"
DATA "1111000000111100"
DATA "0000000000000000"
DATA "1111000000111100"
DATA "0000000000000000"
DATA "1111000000111100"
